# # # # # # #
# S . . . . #
# # # # # . #
# . . . . . #
# . # # # # #
# . . . . E #
# # # # # # #