# # # # # # # #
# S . . . . . #
# . # # # # # #
# . . . . . . #
# # # # # # . #
# E . . . . . #
# # # # # # # #