# # # # # # # # # # # # # # # # # # # #
# S . # . . . . . . . . . # . . . . . #
# . # # . # # # # # # # . # . # # # . #
# . . . . # . . . . . # . . . # . . . #
# # # # # # . # # # . # # # # # . # # #
# . . . . . . # . . . . . . . . . . . #
# . # # # # # # . # # # # # # # # # . #
# . . . . . . . . # . . . . . . . # . #
# # # # # # # # . # . # # # # # . # . #
# . . . . . . # . # . # . . . . . # . #
# . # # # # . # . # . # . # # # # # . #
# . # . . . . # . . . # . . . . . . . #
# . # . # # # # # # # # # # # # # # . #
# . # . . . . . . . . . . . . . . # . #
# . # # # # # # # # # # # # # # . # . #
# . # . . . . . . . . . . . . . . # . #
# . # . # # # # # # # # # # # # # # . #
# . . . . . . . . . . . . . . . . . . #
# # # # # # # # # # # # # # # # # # . E
# # # # # # # # # # # # # # # # # # # #