# # # # # # # # # # # # # # # # # # # #
# S . . . # . . . . . . # . . . . . . #
# # # # . # . # # # # . # . # # # # . #
# . . . . # . # . . # . . . # . . # . #
# . # # # # . # . . # # # # # . . # . #
# . # . . . . # # . . . . . . . # # . #
# . # . # # # # # # # # # # # . # . . #
# . . . # . . . . . . . . . # . # . # #
# # # # # . # # # # # # # . # . # . . #
# . . . . . # . . . . . # . # . # # . #
# . # # # # # . # # # . # . # . . # . #
# . # . . . . . # . # . # . # # . # . #
# . # . # # # # # . # . # . . # . # . #
# . . . # . . . . . # . # # . # . . . #
# # # # # . # # # # # . . # . # # # # #
# . . . . . # . . . # # . # . . . . . #
# . # # # # # . # . . # . # # # # # . #
# . # . . . . . # # . # . . . . . # . #
# . # # # # # # # # . # # # # # . . E #
# # # # # # # # # # # # # # # # # # # #