# # # # # # #
# S . . # . #
# . # . # . #
# . # . . . #
# . # # # . #
# . . . . . E
# # # # # # #