# # # # # #
# S . . . #
# . . . . #
# . . . . #
# . . . E #
# # # # # #